R  1 1        
NO  ./textures/wall_1.xpm

SO ./textures/wall_2.xpm
WE ./textures/wall_3.xpm
EA ./textures/wall_4.xpm

S ./textures/sprite_1.xpm

F  0, 0, 0          
C 50, 61, 255

    1111111111111111111111  1111
    10100000000000000000011 1101
    11101000022222222200001111111
    11000120000000200000011  101
    101010000222222222000011 101
    101010000222222222000011 101
    101010000222222222000011 101
    101010000222222222000011 101
    101010000222222222000011 101
    101010100222111222000011 101
    101010000222101222000011 101
    101010000222111222000011 101
    101010000222222222000011 101
    10101000022222222200N011 101
    101010000222222222000011 101
    101010000222222222000011 101
    101010000222222222000011 101
    101010000222222222000011 101
    101010000222222222000011 101
    101010000222222222000011 101
    101010000222222222000011 101
    101010000222222222000011 101
    101010000222222222000011 101
    101010000222222222000011 101
    101010000222222222000011 101
    101010000222222222000011 101
    101010000222222222000011 101
    101010000222222222000011 101
    101010000222222222000011 101
    101010000222222222000011 101
    101010000222222222000011 101
    10000000000000000000001  111
    11111111111111111111111