
R 1000 1000



NO      ./textures/wall_1.xpm
        
         
SO ./textures/wall_4.xpm
EA          ./textures/wall_2.xpm
F 0,  255,       0              
WE                  ./textures/wall_3.xpm

S           ./textures/sprite_1.xpm
C       0   0,   255
                
                    
              11111111             111111
              10000001     1111    100001
1111111111111110111111     1101    111001
12222220000010000000011111110111111100111
1000000000010000000001 1S1 111     111011
1202010100000000000111 111  11111    1101
11111111111101111111111     10001     101
100000001100000111011111    10001     101
100001110111111110000011    11001     101
101101111010101011010101    11101     101
110000001001010111000001    11001     101
100000000000000110000011    10001     101
100022000000010011010101    10001     101
110020001101010111110111    10001     101
111101111111011110000001    10001     101111
111101111111001000000001    1000111111111101
110000001010000010000001    1000000000000001
100000001100000011000001    1000111111111101
100000000001111011100011    10001      11101
100000011111111100101011111110011     111001
110000000000011010000000000000011     100001
100000111000001101010101111111111     110001
100000011000011100000001              111111
100000011100010110101011                     
11000001 100011110100011                     
11111111 11111111111111                      